11 3 13 7 5 1 5 9 3 9 11
6 4 1 13 7 0 9 6 12 6 12
7 9 6 1 5 8 14 3 5 13 11
11 6 9 2 9 6 9 2 9 3 12
6 1 4 12 14 3 4 8 2 12 11
3 12 11 3 13 2 9 10 6 1 12
6 5 4 12 7 12 14 6 13 6 13