3 5 5 5 1 5 5 5 5 5 5 5 9
10 3 5 5 4 5 5 5 5 5 5 9 10
10 10 11 3 5 9 3 5 1 5 9 10 10
10 10 10 2 9 10 6 9 10 3 8 10 10
10 10 6 12 6 4 5 12 6 8 14 10 10
10 6 5 5 5 5 5 5 5 4 5 12 10
6 5 5 5 5 5 5 5 5 5 5 5 12
