3 5 5 9 3 5 5 5 5 5 5 9
10 3 5 0 8 3 5 5 5 5 9 10
10 10 11 2 8 10 3 5 5 9 10 10
6 0 0 4 12 10 6 5 9 6 0 8
3 0 4 9 3 4 5 9 10 3 12 10
10 14 3 8 10 3 9 10 6 4 1 8
6 1 0 12 10 6 8 2 5 9 10 14
3 0 0 9 6 5 12 14 3 4 4 9
10 10 2 0 1 5 5 5 12 3 5 8
10 10 6 4 4 1 5 5 9 2 5 12
2 0 5 5 1 8 3 5 12 6 5 9
6 4 5 5 4 12 6 5 5 5 5 12
