3 5 5 5 5 5 5 5 5 9
10 3 5 5 9 3 5 5 9 10
10 10 3 9 10 10 3 9 10 10
10 10 14 10 10 10 10 14 10 10
10 6 5 12 10 10 6 5 12 10
6 5 5 5 12 6 5 5 5 12